1111111
1C0#0C1
100P0M1
1C0E0C1
1111111