1111111
1C000C1
1M0P0P1
1C0E0C1
1111111