1111111111111111111111111111111111
100000000000000C00000C000000000101
1010010100100000101001000000010101
1010100101010100010010000000010101
1P0000000C00C0000000000000000001C1
10000000000000C00000C0000000000001
1010010100100000101001000000010001
1010010010101010001001000000010001
10000000C00C00000000000000000000C1
1E0000000000000C00000C000000000001
1010010100100000101001000000010001
1MC0100101010100010010000000010011
10000000C00C00000000000000000000C1
1111111111111111111111111111111111