1111111
1C0M0C1
100P001
0C0E0C0
1111111