1111111
1C000C1
101P001
1C0E0C1
1111111