1111111
1C000C1
100P0P1
1C0E0C1
1111111