1111111
1C0#0C1
100P001
1C0E0C1
1111111