1111111
1C000C1
100P001
0C0E0C0
1111111